16 16
02 02 02 02 02 02 02 02 02 02 02 02 02 02 02 02
02 02 07 02 07 02 02 02 02 02 02 07 02 02 26 28
28 02 02 02 02 02 02 02 26 28 02 02 02 26 37 37
37 27 27 27 27 27 02 02 37 37 28 27 28 37 37 37
37 37 37 37 37 37 02 02 37 37 37 37 37 37 37 37
37 37 37 37 37 37 02 02 37 37 37 37 37 37 37 37
37 37 37 14 37 38 02 02 37 37 37 37 37 37 37 37
37 37 38 02 02 02 02 02 37 37 37 37 37 37 37 37
37 38 02 02 02 02 02 02 37 37 37 37 37 37 37 37
38 02 02 02 02 02 02 02 36 37 37 37 37 37 37 37
02 02 02 02 02 02 02 02 02 02 02 02 02 02 02 02
02 02 02 02 02 02 02 02 02 02 02 02 02 02 02 02
28 02 02 02 02 02 02 02 02 02 02 02 02 26 27 28
37 02 02 02 02 02 02 02 02 02 02 02 02 37 37 37
37 02 02 02 02 02 02 02 02 02 02 02 02 37 37 37
37 27 27 27 27 27 27 27 27 27 27 27 27 37 37 37
